Groovy	Groovy
build	构建
War	War
interface	接口
local variables	局部变量
closures	闭包
dependencies	依赖
Repositories	仓库
predicate	断言
Finalizer	析构器
Example	示例
Ant	Ant
statements	语句
echo	echo
QUIET	QUIET
LIFECYCLE	LIFECYCLE
Ivy	Ivy
logging system	日志系统
user interfaces	用户界面
snappy	敏捷
Intellij IDEA	Intellij IDEA
process	进程
daemon	守护进程
property	属性
import	导入
assembly language	汇编语言
native assembly language	本机汇编语言
Objective-C	Objective-C
Objective-C++	Objective-C++
dashboard	主控面板
consistency	一致性
take advantage	利用
Sonar	Sonar
aggregated metrics	综合指标
Sonar Runner	Sonar Runner
Assuming	如果
conj.	如果
adj.	傲慢的，自负的;僭越的
v.	取得（权力）( assume的现在分词);假设(assume的ing形式);假定;呈现
notably	尤其
